1111111111111111
1P00000000000001
1EC0000000000201
1111111111111111